Â¬	negatzione
|	lÃ¬nia verticale
~	tilde
â‰¥	prus mannu o uguale
ğŸ˜€	aberta, buca, buca risulana, cara, cara risulana, fatze, iscantzada, iscantzende, risu, risulanu
ğŸ˜ƒ	aberta, buca, buca risulana, cara, cara cun ogros ispamparriados, cara cun ogros mannos, cara risulana cun ogros ispamparriados, fatze, iscantzada, iscantzende, ispamparriados, risu, risulanu
ğŸ˜„	aberta, buca, buca risulana, cara, cara cun ogros chi rident, cara cun ogros risulanos, cara risulana cun sos ogros chi rident, fatze, iscantzada, iscantzende, risu, risulanu
ğŸ˜º	aberta, buca, buca risulana, cara, gatu, gatu risulanu, iscantzada, iscantzende, pisitu, risu, risulanu
ğŸ˜¸	aberta, buca, buca risulana, cara, gatu, gatu cun ogros chi rident, gatu cun ogros risulanos, gatu risulanu cun sos ogros chi rident, iscantzada, iscantzende, pisitu, risu, risulanu
ğŸ˜¹	cara, cuntentesa, gatu, gatu cun lÃ grimas de cuntentesa, lÃ grimas, pisitu
ğŸ˜»	amore, cara, coro, gatu, gatu risulanu cun ogros a forma de coro, ogros, ogru, pisitu, risitu, risulanu
ğŸ˜¼	befulanu, cara, gatu, gatu befulanu, irÃ²nicu, pisitu, risitu
ğŸ˜½	basu, cara, gatu, gatu chi mandat basos, ogros serrados, pisitu
ğŸ™€	assustadu, cara, gatu, gatu istasidu, ispantadu, ispramadu, istasidu, istracu, oh, pisitu
ğŸ˜¿	cara, gatu, gatu chi pranghet, lÃ grimas, pisitu, pranghende, prÃ nghere, tristu
ğŸ˜¾	abbuddadu, ammurrionadu, cara, gatu, gatu a murru longu, inchighiristadu, murrilongu, murrione, murru longu, mutriosu, mutzighiladu, neghidadu
ğŸ™ˆ	bidere, cara, mala, male, malu, manos in ogros, martinica, martinica chi non bidet su male, muninca, muninca chi non bidet su male, muninca covechendeÂ·si sos ogros, non bido, ogros, ogros covecados
ğŸ™‰	cara, intendere, mala, male, malu, manos in sas origras, martinica, martinica chi no intendet su male, muninca, muninca chi no intendet su male, muninca covechendeÂ·si sas origras, no intendo, no iscurto, origras, origras covecadas
ğŸ™Š	buca, cara, covechendeÂ·si sa buca, mala, male, malu, manos in buca, martinica, martinica chi non narat cosa mala, muninca, muninca a manos in buca, muninca chi non narat cosa mala, muninca covechendeÂ·si sa buca, non faeddo, non naro
ğŸ’Œ	lÃ¬tera de amore
ğŸ’•	amore, duos coros, istima
ğŸ§¡	arantzu, coro, coro arantzu, emotzione
ğŸ’›	coro, coro grogu, emotzione, grogu
ğŸ’š	birde, coro, coro birde, emotzione
ğŸ’™	asulu, biaitu, coro, coro asulu, emotzione
ğŸ’œ	coro, coro tanadu, emotzione, pÃ¹rpura, tanadu
ğŸ¤	baju, castÃ ngiu, coro, coro castÃ ngiu, emotzione
ğŸ–¤	coro, coro nieddu, dolore, nieddu, tristura
ğŸ¤	arbu, biancu, coro, coro biancu, emotzione
ğŸ’¯	100, 100 puntos, puntos, puntÃ¨giu prenu
ğŸ¦µ	anca, carche, cÃ rchida, mermu, punta de pee
ğŸ¦¶	pee
ğŸ‘‚ï¸	corpus, origra
ğŸ‘ƒ	corpus, nasu
ğŸ§ 	abbistu, cherbeddu, inteligente
ğŸ«	purmones
ğŸ¦·	dente, dentista
ğŸ¦´	ischÃ¨letru, ossu
ğŸ‘€	cara, fatze, ogros, ogru
ğŸ‘ï¸	corpus, ogru
ğŸ‘…	corpus, limba
ğŸ‘„	buca, lavras
ğŸ«¦	amorare, anneu, buca chi mÃ²ssigat is lavras, buca chi mÃ²ssigat sas lavras, diosare, indiosare, oriolada, orioladu, oriolu, pensamentosa, pensamentosu, pensamentu, timoria
ğŸ‘¶	criu
ğŸ§’	giÃ²vana, giÃ²vanu, pisedda, piseddu, pitzinna, pitzinnedda, pitzinneddu, pitzinnu, pitzoca, pitzochedda, pitzocheddu, pitzocu
ğŸ‘¦	giÃ²vanu, pitzinnu, pitzocu
ğŸ‘§	giÃ²vana, pitzinna, pitzoca, vÃ¬rgine, zodÃ¬acu
ğŸ§‘	adulta, adultu, manna, mannu, persone
ğŸ‘±	brunda, brundu, persone brunda, pilos brundos
ğŸ‘¨	adultu, mannu, Ã²mine
ğŸ§”	barba, persone barbuda
ğŸ§”â€â™‚	barba, Ã²mine, Ã²mine barbudu
ğŸ‘©	adulta, fÃ¨mina, manna
ğŸ§”â€â™€	barba, fÃ¨mina, fÃ¨mina barbuda
ğŸ§“	adulta, adultu, antziana, antzianu, betza, betzu, manna, mannu, persone antziana
ğŸ‘´	adultu, antzianu, betzu, mannu, Ã²mine, Ã²mine antzianu
ğŸ‘µ	adulta, antziana, betza, fÃ¨mina, fÃ¨mina antziana, manna
ğŸ¤´	prÃ¬ntzipe
ğŸ‘¸	fantasia, paristÃ²ria, printzesa, printzipessa
ğŸ¤°	fÃ¨mina, fÃ¨mina prÃ¬ngia, prÃ¬ngia
ğŸ‘¼	angheleddu
ğŸ¦¸	bona, bonu, eroe, eroina, supereroe, supereroina, superpodere
ğŸ¦¹	criminale, malu, supercriminale, supermalu, superpodere
ğŸ§™	majÃ rgiu
ğŸ§›	vampiru
ğŸ§	alvu, elfu, mÃ gicu
ğŸ§â€â™‚	alvu Ã²mine, elfu Ã²mine, mÃ gicu
ğŸ§â€â™€	alva, alvu fÃ¨mina, elfa, elfu fÃ¨mina, mÃ gica, mÃ gicu
ğŸ§	djinn, gÃ¨niu
ğŸ§Œ	fantasia, mostru, paristÃ²ria, troll
ğŸ’	basu, croba, cÃ²pia
ğŸ‘ªï¸	famÃ¬lia
ğŸ¦°	piliruja, piliruju, pilos rujos
ğŸ¦±	afro, pilaneddada, pilaneddadu, pilos aneddados, ritzulada, ritzuladu
ğŸ¦³	antzianos, arbos, arbu, betzos, biancos, biancu, cana, canu, incanida, incanidu, murru, pilos, pilos biancos
ğŸ¦²	chemioterapia, chene pilos, iscucada, iscucadu, iscucadura, ispilidu, ispilidura, isplilida, rapada, rapadu, sena pilos
ğŸµ	animale, cara, cara de martinica, fatze, martinica, moninca
ğŸ’	animale, martinica, moninca
ğŸ¦	animale, gorilla
ğŸ¦§	martinica, moninca, orangu, orangutangu
ğŸ¶	animale, cane, cara, fatze, murru, murru de cane
ğŸ•ï¸	animale, cane
ğŸ¦®	atzessibilidade, cane de acumpangiamentu, cane de ghia, tzegos
ğŸ•â€ğŸ¦º	atzessibilidade, cane de agiudu, cane de assistÃ¨ntzia, cane de servÃ¬tziu
ğŸ©	animale, barbontzinu, cane
ğŸº	animale, cara, fatze, lupu, murru
ğŸ¦Š	animale, cara, fatze, grodde, mariane, murru
ğŸ¦	abbistu, animale, curiosu, procione
ğŸ±	animale, cara, fatze, gatu, murru, murru de gatu, murru de pisitu, pisitu
ğŸˆï¸	animale, gatu, pisitu
ğŸˆâ€â¬›	gatu, gatu nieddu, malasorte, nieddu, pisitu
ğŸ¦	animale, cara, fatze, leone, murru, zodÃ¬acu
ğŸ¯	animale, cara, fatze, murru, murru de tigre, tigre
ğŸ…	animale, tigre
ğŸ†	animale, leopardu
ğŸ´	animale, caddu, cara, fatze, murru, murru de caddu
ğŸ	animale, caddu, cursas, ecuitatzione
ğŸ¦„	animale, cara, fazte, murru, unicornu
ğŸ¦“	animale, cara, fatze, istrÃ¬scias, murru, zebra
ğŸ¦Œ	animale, cherbu, chervu, crebu
ğŸ¦¬	animale, bisonte, bÃ¹falu, chedda, gama, masone, mÃ ndria, tÃ giu
ğŸ®	animale, baca, cara, fatze, murru, murru de baca
ğŸ‚	animale, boe, malloru, trau, zodÃ¬acu
ğŸƒ	animale, bÃ¹falu, bÃ¹falu de abba
ğŸ„	baca
ğŸ·	animale, cara, fatze, majale, mannale, murru, murru de porcu, porcu, rebedustu, tzotzo, tzotzu
ğŸ–	animale, majale, mannale, porcu, rebedustu, tzotzo, tzotzu
ğŸ—	animale, sirbone
ğŸ½	animale, cara, fatze, majale, mannale, murru, nasu, nasu de porcu, porcu, rebedustu, tzotzo, tzotzu
ğŸ	animale, bedustu, berrile, mascru, mascru de sa berbeghe, rebedustu
ğŸ‘	animale, berbeghe
ğŸ	animale, capricornu, craba, crabucorru, zodÃ¬acu
ğŸª	animale, cammellu, dromedÃ riu, gobba, tzumba, tzurumba
ğŸ«	animale, cammellu, gobba, tzumba, tzurumba
ğŸ¦™	alpaca, animale, guanaco, lama, lana, vicuna, vicuÃ±a
ğŸ¦’	animale, girafa, macras, puntigheddos
ğŸ˜	animale, elefante
ğŸ¦£	animale, estintzione, lanosu, mammÃ¹t, mannu, sanna
ğŸ¦	animale, rinotzeronte
ğŸ¦›	animale, ipopÃ²tamu
ğŸ­	animale, murru de sÃ²righe, murru de topi, sÃ²righe, topi
ğŸ	animale, sÃ²righe, topi
ğŸ€	animale, ratu
ğŸ¹	animale, cara, critzetu, fatze, murru
ğŸ°	animale, cara, cunillu, fatze, murru, murru de cunillu
ğŸ‡	animale, cunillu
ğŸ¿ï¸	animale, iscojÃ tulu
ğŸ¦«	animale, castoru, diga
ğŸ¦”	animale, eritzu, ischissone, ispinosu
ğŸ¦‡	alipedde, animale, chighineddu, corrintolu, impeddone, isterripedde, pibiristeddu, pioguladu, ratapignata, sÃ²righe pinnadu, tzichirriolu, tzintzimurreddu, tzintzirriolu, tzutzurreri, untzurrullu, vampiru
ğŸ»	animale, cara, fatze, murru, ursu
ğŸ»â€â„	arbu, biancu, polare, ursu, ursu polare
ğŸ¨	animale, koala, ursu
ğŸ¼	animale, cara, fatze, murru, panda
ğŸ¦¥	animale, brÃ dipu, lentu, mandrone
ğŸ¦¦	anfaneri, animale, lontra, pisca
ğŸ¦¨	animale, fragu, pÃ¹tzola
ğŸ¦˜	AustrÃ lia, animale, brincu, canguru, marsupiale
ğŸ¦¡	animale, cane de riu, tassu, tassu de su mele
ğŸ¾	anca, branca, farranca, pee, rasta, rastas de animales
ğŸ¦ƒ	animale, dindu, piocu, pugione
ğŸ”	animale, pudda, pugione
ğŸ“	animale, cabone, puddu, pugione
ğŸ£	animale, pudda, puddighinu, puddighinu essende dae sâ€™ou, puddighinu naschende, puddu, pugione
ğŸ¤	animale, pudda, puddighinu, puddu, pugione
ğŸ¥	animale, puddighinu, puddighinu abbaidadu in cara, puddighinu castiadu in cara, puddighinu pompiadu in cara, pugione
ğŸ¦ï¸	animale, pugione
ğŸ§	animale, pinguinu, pugione
ğŸ•Šï¸	animale, bolu, culumba, olia, paghe, pasca, pugione
ğŸ¦…	altanera, animale, pugione, Ã bbila, Ã bbile
ğŸ¦†	anade, animale, cracatzola, nada, pugione
ğŸ¦¢	anadiscu feu, anadiscu lÃ¨giu, animale, chÃ¬ghinu, pugione, sÃ¬sini, tzignu
ğŸ¦‰	animale, connoschÃ¨ntzia, cucu, cucumeu, cucumiau, pugione, sabidoria, sÃ biu
ğŸ¦¤	Mauritius, dodo, estintzione, mannu
ğŸª¶	bolu, lÃ¨bia, lÃ¨biu, pinna, pinninnia, piuma, pugione, puma
ğŸ¦©	animale, gentarrÃ¹bia, gente arrÃ¹bia, gente ruja, mangone, pugione, tropicale
ğŸ¦š	ampompare, animale, artivu, impaonare, impompadu, impomponare, paone, pugione, sisirinare
ğŸ¦œ	allegare, animale, chistionare, faeddare, papagallu, pirata, pugione, repÃ¬tere
ğŸ¸	animale, cara, fatze, rana
ğŸŠ	animale, cocodrillu
ğŸ¢	animale, testÃ¹ghine, tostÃ²ine
ğŸ¦	animale, pistigione, rÃ¨tile, tziligherta, tzintziligherta, tzorrompis, tzÃ¬riga
ğŸ	animale, colovra, colovredda, rÃ¨tile, serpente, zodÃ¬acu
ğŸ²	animale, cara, conca de cradu, conca de dragu, dragone, dragu, fatze, paristÃ²ria
ğŸ‰	animale, dragone, dragu, paristÃ²ria
ğŸ¦•	brachiosÃ uru, brontosÃ uru, dinosÃ uru, diplÃ²docu, saurÃ²podu
ğŸ¦–	t-rex, tirannosÃ uru, tirannosÃ uru rex
ğŸ³	animale, arrusciare, balena, balena ischitzende abba, balena tzaviende abba, crispiare, isbrufulare, ischitzare, ispanzolare, papuschiare, pibiristare, pispisare, pispisiare, tzivinare
ğŸ‹	animale, balena
ğŸ¬	animale, delfinu, gurfinu
ğŸ¦­	animale, baca de modde, bigrumarra, bigrumarras, bitellu marinu, boe marinu, culumarru
ğŸŸï¸	animale, pische, pisches, zodÃ¬acu
ğŸ 	animale, pische, pische tropicale, tropicale
ğŸ¡	animale, pische, pische botza
ğŸ¦ˆ	animale, cane marinu, canisca, canusu, pische, pischecane
ğŸ™	animale, purpu
ğŸš	animale, conchÃ¬giu, croca, croca a ispirale, ispirale, nicu, tufigheddu
ğŸª¸	coraddu, otzÃ¨anu
ğŸŒ	animale, bacacorru, caragolu, cioga, coli-coli, corrobaca, croga, crogu, tabacorra, tapacorra, tapada, tzitzigorru, vaca de corru
ğŸ¦‹	animale, babbarotu, barabÃ tula, calacasu, faghefarina, ispÃ¬ritu, lepi-lepi, mamasciola, mariola, mariposa, meribella, pabedda, papacasu, pompone, tratacasu, vola-vola
ğŸ›	animale, babballoti, babbarotu, berruga, bobborroti, chentuancas, chentupees, cugurra, gremÃ¨ddighe, mamaruga, ruca, ruda, ruga, tzurunga
ğŸœ	animale, babbarotu, formiga, formÃ¬gula
ğŸ	abe, animale, babbarotu
ğŸª²	boe Tomasu, boe de Tomasu, buvone, carra-carra, carrabusu, carramerda, carravatzu, carravore, tragamerda
ğŸ	animale, babbajola, babbarotu, caramedda, mamajola, mariapesabola, mariola, maritzola, mundiola, pedrupischeddu, pibiola, pipiridonna, tiria, zunzella
ğŸ¦—	animale, babbarotu, coicopira, grillu
ğŸª³	animale, babbajoledda, babbarotu, bobosorighe, cadenale, carrafatzu, carrafone, garrapiu, iscafone, iscarrafione, iscarrafone, iscrabione, paulina
ğŸ•·ï¸	animale, arangiolu, arÃ cnide, babbauda, cantupiludu, cobesciada, francadossu, mariafarranca, marragoti
ğŸ•¸ï¸	arangiolu, chelu de arangiolu, cheluemuru, lanarrÃ ngiu, napa de arangiolu, sedatzu, taddaranu, talaranis, talaranu, tela de arangiolu, tirinnina, veleleu, velu de arangiolu
ğŸ¦‚	animale, furchiddÃ dile, furchiddÃ dula, iscorpione, tenaza, zodÃ¬acu
ğŸ¦Ÿ	animale, babbarotu, maladia, malÃ ria, pesta, tzÃ¬ntzula, virus
ğŸª°	animale, babbarotu, berme, maladia, musca, pesta, pudeschiore, pudesciura, pudrigadura
ğŸª±	animale, anÃ¨llide, babbarotu, berme, fenos, lembrÃ¨chinu, mamaterra, parassita, piberedda, tzilingrone, tzitzilingone, tzorroiga
ğŸ¦ 	ameba, batÃ¨riu, mÃ¬crobu, virus
ğŸ’	frores, matzu, matzu de frores
ğŸŒ¸	cariasa, frore, frore de cariasa, froridura
ğŸ’®	frore, frore arbu, frore biancu
ğŸª·	Vietnam, buddismu, frore, induismu, lotu, puresa, ÃŒndia
ğŸµï¸	pranta, rosighedda
ğŸŒ¹	frore, rosa
ğŸ¥€	acalamadu, allevigiadu, alligiadu, allisiadu, ammortighinadu, calicadu, caliginadu, carigadu, frore, frore alligiadu, mÃ¹stiu, pabassadu, passiu, sicadu, sicu, sumurtidu
ğŸŒº	frore, ibiscu
ğŸŒ»	erba de sole, frore, girasole
ğŸŒ¼	frore
ğŸŒ·	frore, lantzeta, tulipanu
ğŸŒ±	brossa, brota, chimuzone, chiu, froedda, frua, fruedda, frunza, prantighedda, pullone, sirione, sÃ¬riu, tzeurredda, tziriotu, tzuddu
ğŸª´	coltivare, inÃ¹tile, letrangosu, pranta, pranta in vasu
ğŸŒ²	mata, mata semper birde, Ã rbore, Ã rbore semper birde
ğŸŒ³	mata, mata cun fÃ²gias caducas, Ã rbore, Ã rbore cun fÃ²gia caduca
ğŸŒ´	mata, prama, Ã rbore
ğŸŒµ	cÃ ctus, pranta
ğŸŒ¾	ispiga de risu, ispiga de rosu, pranta de risu, pranta de rosu, risu, rosu
ğŸŒ¿	fÃ²gia, pranta
â˜˜ï¸	pranta, trifÃ²giu
ğŸ€	bator fÃ²gias, bonasorte, cuadrifÃ²giu, fortuna
ğŸ	aera, costi, cÃ²stighe, fÃ²gia, fÃ²gia de olÃ dighe, fÃ²gia ruta, olÃ dighe
ğŸ‚	fÃ²gia, fÃ²gia ruta, rughende
ğŸƒ	bentu surbende, fÃ²gia, fÃ²gia in su bentu, Ã linu de bentu
ğŸª¹	nidificatzione, nidu, nidu bÃ²idu
ğŸªº	nidificatzione, nidu, nidu cun oos
ğŸ‡	budrone, frÃ¹tora, ua, Ã ghina
ğŸˆ	frÃ¹tora, melone
ğŸ‰	forÃ stigu, frÃ¹tora, sÃ¬ndria
ğŸŠ	arantzu, frÃ¹tora, mandarinu
ğŸ‹	agrume, frÃ¹tora, limone
ğŸŒ	banana, frÃ¹tora
ğŸ	frÃ¹tora, Ã nanas
ğŸ¥­	frÃ¹tora, mangu, tropicale
ğŸ	frÃ¹tora, mela, mela ruja, ruja
ğŸ	birde, frÃ¹tora, mela, mela birde
ğŸ	frÃ¹tora, pira
ğŸ‘	frÃ¹tora, pÃ¨ssighe
ğŸ’	cariasa, cariasas, frÃ¹tora
ğŸ“	frÃ gula, frÃ¹tora
ğŸ«	baca, murta durche, murtitza, murtitzos, murtitzu
ğŸ¥	frÃ¹tora, kiwi, mÃ ndigu
ğŸ…	birdura, frÃ¹tora, tomata
ğŸ«’	mÃ ndigu, olia
ğŸ¥¥	caciumbu, coco, cocu, nughe de cocu, piÃ±a colada, pramma
ğŸ¥‘	avocado, avocadu, frÃ¹tora, mÃ ndigu
ğŸ†	birdura, pedringiana, pedringianu, perdingiana, perdingianu
ğŸ¥”	birdura, mÃ ndigu, patata, tÃ¹vara
ğŸ¥•	aligÃ rgia, birdura, fustinaga, mÃ ndigu, pastinaga
ğŸŒ½	mais, pannuga, trigu moriscu, triguÃ¬ndia, triguÃ¬ndias
ğŸŒ¶ï¸	pibereddu, picante, Ã spidu
ğŸ«‘	birdura, ortalÃ¬ssia, piberone
ğŸ¥’	birdura, cugÃ¹mene, ortalÃ¬ssia
ğŸ¥¬	birdura a fÃ²gia, birdura a fÃ²gia birde, bok choy, cÃ ule, kale, latuga
ğŸ¥¦	brÃ²culu, cÃ ule a truncu, cÃ ule de conca, pugione de cÃ ule, pupiu de cÃ ule
ğŸ§„	gustu, isaboriare, nuscos, sabore, Ã giu
ğŸ§…	chibudda, gustu, isaboriare, nuscos, sabore
ğŸ„	antunna, buletu, cardulinu, cugumeddu
ğŸ¥œ	birdura, mÃ ndigu, nutzola americana, nutzolas americanas
ğŸ«˜	fasolos, fasolu, legÃ¹menes, mÃ ndigu
ğŸŒ°	castÃ ngia, pranta
ğŸ	cocone, pane
ğŸ¥	cocone, croissant, filone, frantzesu, ismurzu, mÃ ndigu, pane
ğŸ¥–	baguette, cocone, frantzesu, mÃ ndigu, pane
ğŸ«“	arepa, covatza, lavash, naan, pita
ğŸ¥¨	imboligadu, pretzel
ğŸ¥¯	bagel, ismurzu, paneteria
ğŸ¥	crÃªpe, ismurzu, mÃ ndigu, pancake, pancakes
ğŸ§‡	gaufre, ismÃ¹rgiu, waffle
ğŸ”	burger, hamburger
ğŸŸ	patata frinta, patatas frintas
ğŸ•	fita, pizza
ğŸŒ­	hot dog
ğŸ¥š	ou
ğŸ§ˆ	butiru
ğŸ§‚	sale
ğŸ£	sushi
ğŸ¼	alleu, bÃ¨vida, crabighera, creadura, criu, late, pipiu, pitzinneddu, puparola, tiralate, tirapetus, titiera
ğŸ¥›	bÃ¨vida, late, tassa, tassa de late
â˜•ï¸	bÃ¨vida, bÃ¨vida caente, caente, cafÃ¨, papore, tÃ¨
ğŸ«–	bÃ¨vida, tejera, tÃ¨
ğŸµ	bÃ¨vida, tzÃ¬chera, tzÃ¬chera de tÃ¨, tzÃ¬chera de tÃ¨ chene asa, tzÃ¬chera de tÃ¨ chene mÃ nigu, tÃ¨
ğŸ¶	ampulla, bÃ¨vida, sakÃ¨, tassa, tzilleri
ğŸ¥¢	bachitas, hashi
ğŸ½ï¸	coghina, furcheta, furcheta e leputzu cun pratu, leputzu, pratu, pratu cun posadas
ğŸ´	coghina, furcheta, furcheta e leputzu, leputzu, posadas
ğŸ¥„	cullera, posada
ğŸ”ª	arma, coghina, leputzu, leputzu de coghina, traste
ğŸ«™	boto, butega, bÃ²idu, cundimentu, cuntenidore, nuscos, pimentas
ğŸº	abbÃ rgiu, broca, bÃ¨vida, coghina, sinnu zodiacale, ziru, zodÃ¬acu, Ã nfora
ğŸŒ	Europa, mapamundu, mapamundu chi ammustrat sâ€™Europa e sâ€™Ã€frica, mundu, terra, Ã€frica
ğŸŒï¸	AmÃ¨rica, AmÃ¨ricas, mapamundu, mapamundu chi ammustrat sas AmÃ¨ricas, mapamundu chi ammustrat sâ€™AmÃ¨rica, mundu, terra, world
ğŸŒ	AustrÃ lia, mapamundu, mapamundu chi ammustrat sâ€™Ã€sia e sâ€™AustrÃ lia, mundu, terra, world, Ã€sia
ğŸŒ	mapamundu, mapamundu cun meridianos, meridianos, mundu, terra
ğŸ—ºï¸	mapa, mapa de su mundu, mundu
ğŸ—¾	Giapone, mapa, mapa de su Giapone
ğŸ§­	bÃ¹ssola, magnÃ¨tica, magnÃ¨ticu, navigatzione, nÃ vigu, orientamentu
ğŸ”ï¸	cÃ¹curu, fritu, montagna, monte, monte cun nie, montera, montÃ ngia, nie
â›°ï¸	cÃ¹curu, montagna, monte, montera, montÃ ngia
ğŸŒ‹	cÃ¹curu, erutzione, montagna, monte, montera, montÃ ngia, vulcanu
ğŸ—»	cÃ¹curu, fuji, montagna, monte, monte fuji, montera, montÃ ngia
ğŸ•ï¸	acampamentu, campÃ¨giu, tenda, vacÃ ntzia
ğŸ–ï¸	istiu, mare, para-sole, praja, praja cun para-sole
ğŸœï¸	desertu
ğŸï¸	desertu, soledade, Ã¬sula, Ã¬sula deserta
ğŸï¸	parcu, parcu natzionale
ğŸŸï¸	edifÃ¬tziu, fÃ bricu, istÃ diu
ğŸ›ï¸	clÃ ssicu, edifÃ¬tziu, edifÃ¬tziu clÃ ssicu, fÃ bricu
ğŸ—ï¸	costrutzione, edilÃ¬tzia, fÃ bricu, fÃ bricu de unâ€™edifÃ¬tziu
ğŸ§±	impastu, matone, matones, muru
ğŸª¨	corÃ²ngiu, pedra, perda, pesante, preda, roca, sÃ²lida, sÃ²lidu
ğŸªµ	cotighina, cotzighina, cotzigone, cotzinÃ rgiu, cotzina, linna, linnÃ mene, mutzigone, mutzu, truncu, tzompa
ğŸ›–	barraca, domo, iurta, pinneta, pinnetu
ğŸ˜ï¸	domos, edifÃ¬tzios, fÃ bricos
ğŸšï¸	abbandonada, cadrudda, disabitada, domo, domo chi si nchâ€™est irrughende, rÃ¹dere
ğŸ ï¸	abitatzione, domo, edifÃ¬tziu, fÃ bricu
ğŸ¡	abitatzione, domo, domo cun giardinu, edifÃ¬tziu, fÃ bricu, giardinu
ğŸ¢	edifÃ¬tziu, edifÃ¬tziu de ufÃ¬tzios, fÃ bricu, fÃ bricu de ufÃ¬tzios, ufÃ¬tzios, ufÃ¬tziu
ğŸ£	edifÃ¬tziu, fÃ bricu, giaponesu, postas, ufÃ¬tziu postale, ufÃ¬tziu postale giaponesu
ğŸ¤	edifÃ¬tziu, europeu, fÃ bricu, postas, ufÃ¬tziu postale
ğŸ¥	dutore, edifÃ¬tziu, fÃ bricu, ispidale, meighina, mÃ¨igos, salude
ğŸ¦	banca, edifÃ¬tziu, fÃ bricu
ğŸ¨	albergu, edifÃ¬tziu, fÃ bricu, hotel, posada
ğŸ©	albergu, amore, edifÃ¬tziu, fÃ bricu, hotel, love hotel, motel
ğŸª	butega, butega 24 oras, buteghedda, drogheria, edifÃ¬tziu, fÃ bricu, minimarket
ğŸ«	edifÃ¬tziu, fÃ bricu, iscola
ğŸ¬	butega, edifÃ¬tziu, fÃ bricu, supermercadu
ğŸ­ï¸	edifÃ¬tziu, fÃ brica, fÃ bricu, industria
ğŸ¯	casteddu, casteddu giaponesu, edifÃ¬tziu, fÃ bricu, giaponesu
ğŸ°	casteddu, edifÃ¬tziu, europeu, fÃ bricu
ğŸ’’	amore, capella, coja, cojuiu, cresiedda
ğŸ—¼	Turre de TÃ²kyo, TÃ²kyo, turre
ğŸ—½	IstÃ tua de sa Libertade, istÃ tua, libertade
â›ªï¸	cristianÃ¨simu, crÃ¨sia, edifÃ¬tziu, fÃ bricu, religione, rughe
ğŸ•Œ	edifÃ¬tziu, fÃ bricu, islam, islamismu, moschea, religione
ğŸ›•	edifÃ¬tziu, fÃ bricu, induismu, religione, tÃ¨mpiu, tÃ¨mpiu induista
ğŸ•	ebraismu, edifÃ¬tziu, fÃ bricu, giudaismu, religione, sinagoga, tÃ¨mpiu
â›©ï¸	jinja, religione, santuÃ riu, santuÃ riu shintoista, shintoismu
ğŸ•‹	islam, islamismu, kaaba, religione
â›²ï¸	cÃ ntaru, funtana, grifone, mitza
â›ºï¸	campÃ¨giu, tenda
ğŸŒ	anneuladu, buorosu, bÃ¹ora, fumatzosu, fuscu, nebidosu, neulosu, nÃ¨bida, nÃ¨ula
ğŸŒƒ	isteddas, isteddos, isteddu, note, note cun isteddos
ğŸ™ï¸	edifÃ¬tzios, fÃ bricos, paesÃ giu urbanu, tzitade
ğŸŒ„	arborinu, arbÃ¨schida, arbÃ¨schida in sos montes, mangiana, mangianeddu, mangianile, mangianu, montagnas, monte, montera, montes, sole
ğŸŒ…	arborinu, arbÃ¨schida, mangiana, mangianeddu, mangianile, mangianu
ğŸŒ†	edifÃ¬tzios, fÃ bricos, intrinada, paesÃ giu, sero, tzitade, tzitade a sâ€™intrinada
ğŸŒ‡	edifÃ¬tzios, fÃ bricos, intrinada, paesÃ giu, sole, tzitade
ğŸŒ‰	note, ponte, ponte a de note
â™¨ï¸	calore, fontes termales, mitzas termales, papore, termas
ğŸ 	caddu, caddu de giÃ²stra, giostra
ğŸ›	giogare, giogu, iscagiadÃ²rgiu, lassinadÃ²rgia, lassinadÃ²rgiu, parcu de giogos, trauladÃ²rgiu, Ã rea de ispÃ ssiu
ğŸ¡	intratenimentu, parcu de disaogu, parcu de ispÃ ssiu, roda panorÃ mica
ğŸ¢	intratenimentu, montagnas russas, parcu de disaogu, parcu de ispÃ ssiu
ğŸ’ˆ	barbieri, insigna, palu, palu de barbieri, pelucheri, pilucheri, segada de pilos
ğŸª	intratenimentu, tenda, tendone, tendone de su tzircu, tzircu
ğŸš‚	ferrovia, locomotiva, motore, papore, trenu
ğŸšƒ	elÃ¨tricu, ferrovia, mÃ china, tram, trenu, vagone
ğŸš„	ferrovia, lestresa, shinkansen, trenu, trenu a lestresa arta, velotzidade
ğŸš…	balla, ferrovia, lestresa, shinkansen, trenu, trenu balla, velotzidade
ğŸš†	ferrovia, trenu
ğŸš‡ï¸	metro, metropolitana
ğŸšˆ	binÃ riu lÃ¨biu, ferrovia, metropolitana lÃ¨bia, metrotranvia
ğŸš‰	ferrovia, istatzione, trenu
ğŸšŠ	filubus, tram
ğŸš	monorotÃ ia, veÃ¬culu
ğŸš	ferrovia, ferrovia de monte, ferrovia montana, monte, trenu, veÃ¬culu
ğŸš‹	tram, vagone, vagone de su tram, veÃ¬culu
ğŸšŒ	bus, corriera, postale, veÃ¬culu, Ã utobus
ğŸšï¸	arribende, bus, corriera, in arribu, in arrivu, postale, postale arribende, veÃ¬culu, Ã utobus
ğŸš	bus, filobus, filubus, postalinu cun filu, veÃ¬culu
ğŸš	bus, postale, postalinu, veÃ¬culu
ğŸš‘ï¸	ambulÃ ntzia, veÃ¬culu
ğŸš’	autopompa, cÃ mion, cÃ mion de is pompieris, cÃ mion de sos pompieris, pompieris, veÃ¬culu
ğŸš“	automÃ²bile, mÃ china, mÃ china de sa politzia, patÃ¹llia, politzia, veÃ¬culu
ğŸš”ï¸	arribende, automÃ²bile, in arribu, in arrivu, mÃ china, mÃ china de sa politzia arribende, politzia, veÃ¬culu
ğŸš•	taxi, veÃ¬culu
ğŸš–	arribende, in arribu, in arrivu, taxi, taxi arribende, veÃ¬culu
ğŸš—	automÃ²bile, mÃ china, veÃ¬culu
ğŸš˜ï¸	arribende, automÃ²bile, automÃ²bile arribende, in arribu, in arrivu, mÃ china, veÃ¬culu
ğŸš™	SUV, automÃ²bile, mÃ china, veÃ¬culu
ğŸ›»	camieddu, pick-up, pickup, veÃ¬culu
ğŸšš	cÃ mion, veÃ¬culu
ğŸš›	autoarticuladu, cÃ mion, cÃ mion articuladu, semi-rimÃ²rchiu, veÃ¬culu
ğŸšœ	tratore, veÃ¬culu
ğŸï¸	automÃ²bile de cursa, cursa, mÃ china de cursa, veÃ¬culu, Ã uto de cursa
ğŸï¸	cursa, moto, mototzicleta, veÃ¬culu
ğŸ›µ	motorinu, veÃ¬culu
ğŸ¦½	atzessibilidade, cadira a rodas manuale, carrotzedda manuale, carrutzina manuale
ğŸ¦¼	atzessibilidade, cadira a rodas a motore, cadira a rodas motorizada, carrotzedda a motore, carrotzedda motorizada, carrutzina a motore, carrutzina motorizada
ğŸ›º	risciÃ² a motore, risciÃ² motorizadu, tuk tuk
ğŸš²ï¸	bitzicleta, veÃ¬culu
ğŸ›´	monopÃ tinu
ğŸ›¹	skateboard, tÃ ula de skateboard
ğŸ›¼	pÃ tinos, pÃ tinos a rodeddas
ğŸš	bus, corriera, firmada, firmada de sa corriera, firmada de su postale, postale, Ã utobus
ğŸ›£ï¸	autostrada, caminu, caminu lestru, pedÃ giu
ğŸ›¤ï¸	binÃ rios, ferrovia, trenu
ğŸ›¢ï¸	barile, barile de petrÃ²liu, petrÃ²liu
â›½ï¸	benzina, carburante, istatzione, istatzione de servÃ¬tziu, pompa de benzina
ğŸ›	bortare, chircu, girare, gomma, pneumÃ ticu, roda
ğŸš¨	lughe, lughe de sa politzia, politzia, sirena de sa politzia
ğŸš¥	semÃ foru orizontale, sinnale, trÃ ficu
ğŸš¦	semÃ foru verticale, sinnale, trÃ ficu
ğŸ›‘	otagonale, sinnale, sinnale de stop, stop
ğŸš§	barriera, cantieri, frÃ igu, traballos
âš“ï¸	barca, imbarcatzione, nae, navile, naviu, traste, Ã ncora
ğŸ›Ÿ	agiudu, gallegiante, gallegiare, sarvagente, seguresa, sucursu
â›µï¸	barca, barca a vela, localidade balneare, vela, yacht
ğŸ›¶	barca, canoa, imbarcatzione
ğŸš¤	barca, imbarcatzione, motoscafu
ğŸ›³ï¸	crotziera, imbarcatzione, nave, nave de crotziera, naviu
â›´ï¸	batellu, imbarcatzione, nave, navile, naviu
ğŸ›¥ï¸	barca, barca a motore, imbarcatzione
ğŸš¢	imbarcatzione, nave, naviu
âœˆï¸	aeroplanu, aÃ¨reu, velÃ¬volu
ğŸ›©ï¸	aeroplaneddu, aeroplanu, aeroplanu minore, velÃ¬volu
ğŸ›«	aeroplanu, aÃ¨reu, check-in, decollu, partÃ¨ntzia, tzucada, velÃ¬volu
ğŸ›¬	aeroplanu, arribu, arrivu, aterrÃ giu, aÃ¨reu, velÃ¬volu
ğŸª‚	paracadute, paracadutismu, pararutas
ğŸ’º	cadira, sedile
ğŸš	elicÃ²teru, velÃ¬volu, veÃ¬culu
ğŸšŸ	ferrovia, ferrovia suspesa, ferrovia suspÃ¨ndida
ğŸš 	cabina, funivia, montagna, monte, montera, veÃ¬culu
ğŸš¡	cabina, funivia aÃ¨rea, veÃ¬culu
ğŸ›°ï¸	ispÃ tziu, satÃ¨llite
ğŸš€	ispÃ tziu, razu
ğŸ›¸	UFO, discu chi bolat
ğŸ›ï¸	albergu, campanedda, campanedda de albergu, posada
ğŸ§³	bagÃ lliu, biÃ giu, valÃ¬gia
âŒ›ï¸	arena, rellÃ²giu a arena, rellÃ²giu a arena chene tempus, rellÃ²giu a rena, rellÃ²giu a rena chene tempus, rena, tempus
â³ï¸	arena, rellÃ²giu a arena, rellÃ²giu a arena iscurrende, rellÃ²giu a rena, rellÃ²giu a rena iscurrende, rena, tempus
âŒšï¸	rellÃ²giu, rellÃ²giu de burtzu
â°	isvÃ¨llia, rellÃ²giu
â±ï¸	cronÃ²metru, rellÃ²giu
â²ï¸	rellÃ²giu, temporizadore, timer
ğŸ•°ï¸	rellÃ²giu, rellÃ²giu de consola, rellÃ²giu de mesa, rellÃ²giu de mÃ¨nsola
ğŸ•›ï¸	00:00, 12:00, dÃ²ighi, dÃ²ighi in puntu, in puntu, mesanote, mesudie, mesunote, rellÃ²giu
ğŸ•§	00:30, 12:30, dÃ²ighi e mesa, dÃ²ighi e mesu, mesanote e mesa, mesanote e mesu, mesudie e mesa, mesudie e mesu, mesunote e mesa, mesunote e mesu, rellÃ²giu
ğŸ•ï¸	13:00, 1:00, rellÃ²giu, una, una in puntu
ğŸ•œ	13:30, 1:30, rellÃ²giu, una e mesa, una e mesu
ğŸ•‘ï¸	14:00, 2:00, duas, duas in puntu, rellÃ²giu
ğŸ•	14:30, 2:30, duas e mesa, duas e mesu, rellÃ²giu
ğŸ•’ï¸	15:00, 3:00, rellÃ²giu, tres, tres in puntu
ğŸ•	15:30, 3:30, rellÃ²giu, tres e mesa, tres e mesu
ğŸ•“ï¸	16:00, 4:00, bator, bator in puntu, rellÃ²giu
ğŸ•Ÿ	16:30, 4:30, bator e mesa, bator e mesu, rellÃ²giu
ğŸ•”ï¸	17:00, 5:00, chimbe, chimbe in puntu, rellÃ²giu
ğŸ• 	17:30, 5:30, chimbe e mesa, chimbe e mesu, rellÃ²giu
ğŸ••ï¸	18:00, 6:00, rellÃ²giu, ses, ses in puntu
ğŸ•¡	18:30, 6:30, rellÃ²giu, ses e mesa, ses e mesu
ğŸ•–ï¸	19:00, 7:00, rellÃ²giu, sete, sete in puntu
ğŸ•¢	19:30, 7:30, rellÃ²giu, sete e mesa, sete e mesu
ğŸ•—ï¸	20:00, 8:00, oto, oto in puntu, rellÃ²giu
ğŸ•£	20:30, 8:30, oto e mesa, oto e mesu, rellÃ²giu
ğŸ•˜ï¸	21:00, 9:00, noe, noe in puntu, rellÃ²giu
ğŸ•¤	21:30, 9:30, noe e mesa, noe e mesu, rellÃ²giu
ğŸ•™ï¸	10:00, 22:00, deghe, deghe in puntu, rellÃ²giu
ğŸ•¥	10:30, 22:30, deghe e mesa, deghe e mesu, rellÃ²giu
ğŸ•šï¸	11:00, 23:00, rellÃ²giu, Ã¹ndighi, Ã¹ndighi in puntu
ğŸ•¦	11:30, 23:30, rellÃ²giu, Ã¹ndighi e mesa, Ã¹ndighi e mesu
ğŸŒ‘	isburridura de luna, iscura, iscuridade, iscuru, isperdimentu de luna, luna, luna noa
ğŸŒ’	creschente, luna, luna creschente
ğŸŒ“	cuartu, luna, primu cuartu de luna
ğŸŒ”	creschente, cumbessa, luna, luna creschente cumbessa
ğŸŒ•ï¸	luna, luna prena, prena
ğŸŒ–	calante, luna, luna calante cumbessa, menguante, minimante
ğŸŒ—	cuartu, musciura, Ã¹rtimu cuartu de luna
ğŸŒ˜	calante, ismenguamentu de luna, luna, luna betza, luna calante, luna modde, menguante, minimante
ğŸŒ™	creschente, farche, farche de luna, luna
ğŸŒš	cara, fatze, luna, luna noa cun cara
ğŸŒ›	cara, cuartu, fatze, luna, primu cuartu de luna cun cara
ğŸŒœï¸	cara, cuartu, fatze, luna, musciura, Ã¹rtimu cuartu de luna cun cara
ğŸŒ¡ï¸	clima, mÃ¨teu, temperadura, tempus, termÃ²metru
â˜€ï¸	calore, lughente, luminosu, rajos, sole, solianu
ğŸŒ	cara, fatze, lughente, luminosa, luna, luna prena cun cara, prena
ğŸŒ	cara, fatze, lughente, luminosu, sole, sole cun cara
ğŸª	Saturnu, praneta cun aneddos, saturninu
â­ï¸	istedda, isteddu, istella
ğŸŒŸ	brillante, istedda, isteddu, isteddu chi brillat, isteddu chi lampat, isteddu lughente, istella, lampante, lughente
ğŸŒ 	falada, falende, irruende, irruta, istedda, isteddu, isteddu coudu, istella, ruende, ruta
ğŸŒŒ	caminu de pÃ gia, galÃ ssia, ispÃ tziu
â˜ï¸	clima, mÃ¨teu, nue, tempus
â›…ï¸	nue, sole, sole in palas de una nue
â›ˆï¸	abba, lampos, lampu, nue, nue cun lampos e abba, proende, temporada, tronos, tronu
ğŸŒ¤ï¸	nue, sole, sole in palas de una nue minoredda
ğŸŒ¥ï¸	nue, sole, sole in palas de una nue manna
ğŸŒ¦ï¸	abba, nue, proghende, sole, sole in palas de una nue cun abba
ğŸŒ§ï¸	abba, nue, nue cun abba
ğŸŒ¨ï¸	fritu, nie, nue, nue cun nie
ğŸŒ©ï¸	lampos, lampu, nue, nue cun lampos, nue cun lampu, rajos, raju
ğŸŒªï¸	momonissa, preidorÃ­ssa, remolinu, tornadu, torvellinu, trumujone
ğŸŒ«ï¸	bÃ¹ora, nÃ¨bida, nÃ¨ula
ğŸŒ¬ï¸	alenu, bentu, cara, cara de bentu, fatze, nue, sulada
ğŸŒ€	momonissa, preidorÃ­ssa, remolinu, tifone, tornadu, torvellinu, trumujone, tziclone, uraganu
ğŸŒˆ	arcu de chelu, chirchiola
ğŸŒ‚	abba, paracu, paracu serradu, parÃ cua, parÃ cua serradu
â˜‚ï¸	abba, paracu, parÃ cua
â˜”ï¸	gÃ¹tios, gÃ¹tios de abba, paracu, paracu cun gÃ¹tios de abba, parÃ cua, parÃ cua cun gÃ¹tios de abba
â›±ï¸	arena, ombrellone, paracuone, parasole, praja, sole, umbrellone
âš¡ï¸	eletritzidade, elÃ¨trica, elÃ¨tricu, lampu, perÃ¬gulu, tensione, tensione arta, voltÃ giu, voltÃ giu artu
â„ï¸	fritu, froca, nie, solla, taddÃ ine
â˜ƒï¸	fritu, nie, santeddu de nie, tzieddu de nie, Ã²mine de nie
â›„ï¸	fritu, nie, santeddu de nie, tzieddu de nie, Ã²mine de nie, Ã²mine de nie chene nie
â˜„ï¸	cometa, ispÃ tziu
ğŸ”¥	aina, fogu, frama
ğŸ’§	fritu, fumetos, fumetu, gÃ¹tiu, sudore
ğŸŒŠ	abba, mare, otzÃ¨anu, unda, unda de abba, unda de su mare
ğŸƒ	Halloween, conca de mortu, festa, is animeddas, is pannigheddas, lanterna, sas Ã nimas, su bÃ¬ddiu longu, su mortu mortu, su pedi cocone, tzuca
ğŸ„	Pasca de Nadale, Paschighedda, mata de Nadale, Ã rbore de Nadale
ğŸ†	festa, fogos de artifÃ¬tziu
ğŸ‡	bengala, festa, fogos de artifÃ¬tziu, ischintiddas
ğŸ§¨	dinamite, fogos de artifÃ¬tziu, petardu
âœ¨	*, chichinita, chichinitas, fraria, frarias, ischinchidda, ischinchiddas, ischintidda, ischintiddas, istedda, isteddu, istella, pispidda, pispiddas
ğŸˆ	festa, palloneddu, pallontzinu
ğŸ‰	coriÃ ndolos, festa, ispara coriÃ ndolos
ğŸŠ	botza, botza de coriÃ ndolos, coriÃ ndolos, festa
ğŸ‹	festa de is isteddas, festa de sos isteddos, giaponesu, mata, mata de Tanabata, Ã rbore, Ã rbore de Tanabata, Ã rbore de sos disÃ¬gios
ğŸ	bambÃ¹, bambÃ¹ decoradu, decoratzione de pinu, festa, giaponesu, kadomatsu, pinu
ğŸ	buatas, festa manna, giaponesas, pupias, pupias giaponesas
ğŸ	bandereddas, bandereddas de carpas, carpas, festa, koinobori
ğŸ	bentu, campana, campana a su bentu, festa
ğŸ‘	cuntemplatzione de sa luna, festa, luna, tzerimÃ²nia, tzerimÃ²nia de osservatzione de sa luna
ğŸ§§	bonasorte, busta ruja, dinare, fortuna, hÃ³ngbÄo, lai see
ğŸ€	chirrione, festa, frocu, pubusa
ğŸ	donu, donu incartadu, festa, incartadu, iscÃ tula, regalu
ğŸ—ï¸	ammentadore, festa, nastru, nastru ammentadore
ğŸŸï¸	ammissione, atzessu, billete, billete de intrada, intrada
ğŸ«	ammissione, atzessu, billete, intrada
ğŸ–ï¸	glorificatzione, medÃ llia, medÃ llia militare, militare
ğŸ†ï¸	prÃ¨miu, trofeu
ğŸ…	medÃ llia, medÃ llia de isport
ğŸ¥‡	medÃ llia, medÃ llia de oro, medÃ llia de su de unu postu, medÃ llia de su primu postu, oro, primu
ğŸ¥ˆ	medÃ llia, medÃ llia de prata, medÃ llia de su de duos postos, medÃ llia de su de duos postu, medÃ llia de su primu postu, prata, segundu
ğŸ¥‰	brunzu, medÃ llia, medÃ llia de brunzu, medÃ llia de su de tres postos, medÃ llia de su de tres postu, medÃ llia de su tertzu postu, tertzu
âš½ï¸	botza, botza de fÃ¹balu, fÃ¹balu
âš¾ï¸	baseball, botza, botza de baseball
ğŸ¥	botza, botza de softball, guante, softball
ğŸ€	basket, botza, botza de basket, canistru, pallacanestro
ğŸ	botza, giogu, pallavolo, volley
ğŸˆ	botza, fÃ¹balu americanu
ğŸ‰	botza, botza de rugby, rugby
ğŸ¾	botza, racheta, tennis
ğŸ¥	discu chi bolat, frisbee, ultimate frisbee
ğŸ³	botza, bowling, giogu
ğŸ	botza, cricket, giogu, matza
ğŸ‘	botza, bÃ culu, giogu, hockey de pradu, matza, pradu
ğŸ’	astra, bÃ culu, discu, giogu, hockey in sâ€™astra, hockey in sâ€™Ã stragu, matza, Ã stragu
ğŸ¥	botza, gol, lacrosse, racheta de lacrosse
ğŸ“	botza, ping pong, racheta, rete, retza, retze, tennis de mesa
ğŸ¸	badminton, giogu, isport, racheta, volanu
ğŸ¥Š	boxe, guante, guante de boxe, guante de pugiladu, pugiladu
ğŸ¥‹	artes martziales, judo, karate, kimono, taekwondo, uniforme, uniforme de artes martziales, uniforme pro artes martziales
ğŸ¥…	gol, isport, porta, rete, retza, retze
â›³ï¸	banderedda in sa buca, buca, golf
â›¸ï¸	astra, patinÃ giu, patinÃ giu artÃ¬sticu, patinÃ giu in sâ€™astra, patinÃ giu in sâ€™Ã stragu, Ã stragu
ğŸ£	canna, canna de pisca, lentza, pisca, pische
ğŸ¤¿	acabussada, bisera, caratza, imberghidura, imberghimentu, impojada, mÃ scara pro sas imbÃ¨rghidas, mÃ schera, snorkeling
ğŸ½	atlÃ¨tica, cursa, fÃ scia, isport, mÃ llia, mÃ llia de cursa
ğŸ¿	iscÃ¬, iscÃ¬s, nie
ğŸ›·	islita, tragu, trÃ ngulu
ğŸ¥Œ	curling, giogu, pedra, pedra de curling, perda, perda de curling, preda, preda de curling
ğŸ¯	bersÃ lliu, corpu diretu, fritza, fritzedda, giogu
ğŸª€	gioghitu, giogu, maretare, maretosu, yo-yo
ğŸª	abbilone, bolare, cometa, pranare
ğŸ±	8, billiardu, botza, botza de billiardu, botza de billiardu de 8, giogu, oto
ğŸ”®	addeinÃ²ngiu, aina, benidore, cristallu, destinu, fantasia, fortuna, isfera, isfera de cristallu, paristÃ²ria
ğŸª„	bachita mÃ gica, brÃ¹scia, brÃ¹sciu, coga, cogu, maia, majÃ rgia, majÃ rgiu
ğŸ§¿	breve, coco, fortile, iscapolÃ riu, mumughe, nazar, ogru malu, pastagna, pinnadellu, punga, sebeste
ğŸª¬	FÃ tima, Maria, Miriam, amparu, breve, coco, fortile, iscapolÃ riu, manu, manu de FÃ tima, mumughe, pastagna, pinnadellu, punga, sebeste
ğŸ®ï¸	controlladore, giogu, videogiogu
ğŸ•¹ï¸	giogu, joystick, leva de giogu, videogiogu
ğŸ°	giogu, machineta mÃ ndiga-dinare, machineta mÃ ndiga-dinari
ğŸ²	dadu, dadu de giogu, giogu, giogu de dados
ğŸ§©	giogu a incastros, incastros, incastru, puzzle, tÃ¨ssera de giogu a incastros, tÃ¨ssera de puzzle
ğŸ§¸	gioghitu, piluche, ursigheddu
ğŸª…	festa, ogliÃ cia, padeddatza, pignada, pinzadatza, sciaciapignada
ğŸª©	ballu, botza de discoteca, brillante, brillare, dantza, discoteca, festa, ispricos
ğŸª†	matrioska, pipia, pupia, pupias russas, rÃ¹ssia
â™ ï¸	bastos, cartas, giogu, piche
â™¥ï¸	cartas, coros, cupas, giogu
â™¦ï¸	cartas, cuadros, dinares, dinaris, giogu, oros
â™£ï¸	cartas, frores, giogu
â™Ÿï¸	iscacos, pedone, pedone de is iscacos, pedone de sos iscacos, sacrificÃ bile
ğŸƒ	carta, giogu, jolly
ğŸ€„ï¸	dragu ruju, dragu ruju de su mahjong, giogu, mahjong, tÃ¨ssera
ğŸ´	carta de giogu de frores, cartas de frores, frores, giaponesu, giogu, hanafuda
ğŸ­ï¸	arte, artes performativas, bisera, caratza, caratzas, mÃ scara, mÃ schera, teÃ tru
ğŸ–¼ï¸	arte, cornitze, cuadru, cuadru incornitzadu, guarnissa, immÃ gine, museu, pintura
ğŸ¨	arte, museu, pintura, tauledda, tauledda de is colores, tauledda de pintore, tauledda de sos colores
ğŸ§µ	agu, cosÃ¬ngiu, filu, rodineddu
ğŸª¡	agu, agu pro cosire, cosÃ¬ngiu, puntos, ricamu, sartoria, suturas
ğŸ§¶	botza, busare, glÃ²muru, grÃ²muru, isferrutzare, lÃ²muru, rumbulone, unchineddu
ğŸª¢	acapiadu, acapiare, annodadu, annodare, corda, ispagu, ligadu, ligare, nodu
ğŸ‘“ï¸	bistimentas, ogru, ulleras, ulleras de vista
ğŸ•¶ï¸	iscuru, ogru, ulleras, ulleras de sole
ğŸ¥½	amparu de sos ogros, bisera, caratza, mÃ scara, mÃ schera, nadare, nadÃ²ngiu, saldadura
ğŸ¥¼	cÃ mitze, cÃ mitze de laboratÃ²riu, dutora, dutore, esprimentu, iscientziadu, mÃ¨iga, mÃ¨igu
ğŸ¦º	antinfortunÃ¬stica, corpete, corpete de seguresa, emergÃ¨ntzia, gileco, seguresa
ğŸ‘”	bestimenta, corbata
ğŸ‘•	bestimenta, malliedda
ğŸ‘–	bestimenta, cartzones, jeans, pantalones, ragas
ğŸ§£	coddu, isserpa, tzugru
ğŸ§¤	guantes, manu
ğŸ§¥	caparone, capoto, capotu, gabbanu, giaca, giacheta, redingote, redingotu, serenicu
ğŸ§¦	cartzas, cartzitas, mesascartzas, migigheddas, mÃ¬gias
ğŸ‘—	bestimenta, bestire
ğŸ‘˜	bestimenta, bestire, kimono
ğŸ¥»	bestimenta, bestire, sari
ğŸ©±	costuminu, costuminu intreu
ğŸ©²	costuminu, costuminu de Ã²mine, islip, mudandas, mudandas de Ã²mine, slip, Ã¬ntimu
ğŸ©³	bermuda, cartzoneddos, costuminu, pantaloneddos, Ã¬ntimu
ğŸ‘™	bestimenta, bikini, costuminu, costuminu de fÃ¨mina
ğŸ‘š	bestimenta, bestire de fÃ¨mina, fÃ¨mina
ğŸ‘›	bestimenta, bussighedda, bussiotu, dinare, dinari, moneda, monedas, taschinu
ğŸ‘œ	bestimenta, bursa, bussa, bussedda, bussighedda
ğŸ‘	bestimenta, butzachedda, taschinu
ğŸ›ï¸	bursas, bursas de ispesa, bussas, bussas de ispesa, cÃ²mporas
ğŸ’	iscola, zÃ inu, zÃ inu de iscola
ğŸ©´	cartzola, cartzola cun filu, cartzola de praja
ğŸ‘	bestimenta, bota, iscarpa, iscarpa de Ã²mine, iscrapita, iscrapita de Ã²mine
ğŸ‘Ÿ	bestimenta, iscarpa, iscarpa de cursa, iscarpa de tennis, iscarpa isportiva, iscrapita
ğŸ¥¾	bota, bota de escursionismu, campÃ¨giu, escursionismu
ğŸ¥¿	ballerina, iscarpa bassa, iscarpa chene latzos, iscarpa sena latzos, iscrapita
ğŸ‘ 	bestimenta, fÃ¨mina, iscarpa, iscarpa cun su tacu, iscrapita, tacone, tacu
ğŸ‘¡	bestimenta, fÃ¨mina, iscarpa, iscrapita, sÃ ndalu, sÃ ndalu de fÃ¨mina
ğŸ©°	balligheddu, ballitu, iscarpitas de ballerinas, iscarpitas de balligheddu, iscarpitas de ballitu, iscarpitas pro ballerinas, iscrapitas
ğŸ‘¢	bestimenta, bota, bota de fÃ¨mina, fÃ¨mina, iscarpa
ğŸ‘‘	bestimenta, corona, re, rei, reina
ğŸ‘’	bestimenta, bonete, bonete de fÃ¨mina, capeddu, capeddu de fÃ¨mina, fÃ¨mina
ğŸ©	bestimenta, bonete, bonete a tzilindru, capeddu, capeddu a tzilindru, tzilindru
ğŸ“ï¸	bestimenta, bonete, bonete de laureadu, capeddu, capeddu de laureadu, festa, laÃ¹rea, tzelebratzione
ğŸ§¢	bonete cun visiera, bonete de baseball, capeddu cun visiera, capeddu de baseball
ğŸª–	elmetu, elmetu militare, elmu, esÃ¨rtzitu, gherreri, mirrione, sordadu
â›‘ï¸	agiudu, arba, bianca, cascu, cascu cun rughe arba, cascu cun rughe bianca, elmetu, elmetu cun rughe arba, elmetu cun rughe bianca, rughe, sucursu
ğŸ“¿	bestimenta, collana, pregadoria, preghiera, religione, rosÃ riu
ğŸ’„	arrubieddu, arrubietu, cosmÃ¨ticos, russetu, trucos, trucu
ğŸ’	aneddu, diamante
ğŸ’	diamante, gemma, prenda
ğŸ”‡	a sa muda, altoparlante istudadu, altoparlante mortu, istudadu, mortu, silentziosu
ğŸ”ˆï¸	altoparlante a volume bassu, volume bassu
ğŸ”‰	altoparlante a volume mesanu, altoparlante a volume mÃ¨diu, volume mesanu, voulme mÃ¨diu
ğŸ”Š	altoparlante a volume artu, volume artu
ğŸ“¢	altoparlante, discursu pÃ¹blicu, megÃ fonu
ğŸ“£	altoparlante, megÃ fonu, tifu
ğŸ“¯	cornu postale, posta, postas
ğŸ””	campana, campanedda
ğŸ”•	a sa muda, campana, campana istangada, campanedda, campanedda istangada, mudÃ¬mene, proibidu, silÃ¨ntziu
ğŸ¼	mÃ¹sica, partidura, partidura musicale, pentagramma
ğŸµ	mÃ¹sica, nota, nota musicale
ğŸ¶	mÃ¹sica, nota, notas, notas musicales
ğŸ™ï¸	istÃ¹diu, micrÃ²fonu, micrÃ²fonu de istÃ¹diu, mÃ¹sica
ğŸšï¸	controllu, controllu de su volume, cursore, cursore de su volume, mÃ¹sica, volume
ğŸ›ï¸	controllu, manÃ²pulas, manÃ²pulas de controllu, mÃ¹sica
ğŸ¤	karaoke, micrÃ²fonu
ğŸ§ï¸	auricolares, cÃ¹fias
ğŸ“»ï¸	rÃ diu
ğŸ·	istrumentu, istrumentu musicale, mÃ¹sica, sassÃ²fonu
ğŸª—	fisarmÃ²nica, organeddu, organete, organitu, soneddu, sonetu, sonu
ğŸ¸	chitarra, chiterra, istrumentu, istrumentu musicale, mÃ¹sica
ğŸ¹	istrumentu, istrumentu musicale, mÃ¹sica, pianoforte, pianu, tastieras, tecladu, tecladu musicale
ğŸº	istrumentu, istrumentu musicale, mÃ¹sica, trumba
ğŸ»	istrumentu, istrumentu musicale, mÃ¹sica, violinu
ğŸª•	banjo, istrumentu, istrumentu a cordas, istrumentu musicale, mÃ¹sica
ğŸ¥	bachitas, istrumentu, istrumentu musicale, mÃ¹sica, tamburu
ğŸª˜	bonghitu, bongu, conga, istrumentu, istrumentu musicale, mÃ¹sica, ritmu, tamburu, tamburu longu
ğŸ“±	telefoneddu, telÃ¨fono, telÃ¨fono mÃ²bile, telÃ¨fonu, telÃ¨fonu mÃ²bile, tzellulare
ğŸ“²	fritza, mutida, mutida in intrada, retzende, telefoneddu, telefoneddu cun fritza, telÃ¨fono, telÃ¨fonu, telÃ¨fonu mÃ²bile
â˜ï¸	telÃ¨fono, telÃ¨fonu
ğŸ“	corneta, corneta de su telÃ¨fono, corneta de su telÃ¨fonu, telÃ¨fono, telÃ¨fonu
ğŸ“Ÿï¸	chircapersones
ğŸ“ 	fax
ğŸ”‹	bateria
ğŸª«	bateria bassa, bateria iscarrigada, bateria iscÃ rriga, eletrÃ²nica, energia bassa
ğŸ”Œ	eletritzidade, elÃ¨tricu, ispina elÃ¨trica
ğŸ’»ï¸	carculadore, cumputadore, elaboradore, elaboradore portÃ tile, mÃ²bile, ordinadore, portÃ tile
ğŸ–¥ï¸	carculadore, cumputadore, elaboradore de iscrivania, elaboradore fissu, ordinadore
ğŸ–¨ï¸	carculadore, cumputadore, elaboradore, imprentadora, ordinadore
âŒ¨ï¸	carculadore, cumputadore, elaboradore, ordinadore, tastiera, tecladu
ğŸ–±ï¸	carculadore, cumputadore, elaboradore, ordinadore, ratu, ratu de sâ€™ordinadore, sÃ²righe, topi
ğŸ–²ï¸	botza de controllu, carculadore, cumputadore, elaboradore, ordinadore, trackball
ğŸ’½	carculadore, cumputadore, discu, elaboradore, minidiscu, ordinadore, Ã²ticu
ğŸ’¾	carculadore, cumputadore, discheddu, discu, elaboradore, floppy, floppy disc, ordinadore
ğŸ’¿ï¸	carculadore, cd, cumputadore, discu, discu Ã²ticu, elaboradore, ordinadore, Ã²ticu
ğŸ“€	blu-ray, carculadore, cumputadore, discu, dvd, elaboradore, ordinadore, Ã²ticu
ğŸ§®	cÃ rculu, Ã bacu
ğŸ¥	film, tzinepresa, tzÃ¬nema, videocÃ mera
ğŸï¸	film, fotogrammas, pellÃ¬cula, pellÃ¬cula tzinematogrÃ fica, tzÃ¬nema
ğŸ“½ï¸	film, projetore, projetore tzinematogrÃ ficu, tzÃ¬nema, vÃ¬deu
ğŸ¬ï¸	ciÃ c, ciÃ k, film, tzÃ¬nema
ğŸ“ºï¸	televisione, tv, vÃ¬deu
ğŸ“·ï¸	fotocÃ mera, fotografia, mÃ china fotogrÃ fica
ğŸ“¸	flash, fotocÃ mera, fotocÃ mera cun su flash, mÃ china fotogrÃ fica, mÃ china fotogrÃ fica cun su flash
ğŸ“¹ï¸	telecÃ mera, videocÃ mera, vÃ¬deu
ğŸ“¼	casseta, cassita, vhs, videocasseta, videocassita, vÃ¬deu
ğŸ”	aina, chirca, lente, lente de ismanniamentu, lente de ismanniamentu orientada cara a manca, traste, trastu
ğŸ”	aina, chirca, lente, lente de ismanniamentu, lente de ismanniamentu orientada cara a destra, traste, trastu
ğŸ•¯ï¸	candela, lughe
ğŸ’¡	eletritzidade, elÃ¨trica, fumetu, idea, lampadina, lughe
ğŸ”¦	elÃ¨trica, lughe, pila, tortza, traste
ğŸ®	izakaya, lanterna, lanterna de paperi ruju, lanterna ruja, locale, lughe, tzilleri
ğŸª”	diya, lÃ mpada, lÃ mpada a Ã²giu, lÃ mpada diya, Ã²giu
ğŸ“”	cobertedda decorada, cuadernu, cuadernu cun cobertedda decorada, tacuinu, tacuinu cun cobertedda decorada
ğŸ“•	libru, libru serradu, libru tancadu
ğŸ“–	libru, libru abertu
ğŸ“—	libru, libru birde
ğŸ“˜	libru, libru biaitu
ğŸ“™	libru, libru arantzu, libru in colore de arantzu
ğŸ“šï¸	libros, libru
ğŸ““	cuadernu
ğŸ“’	cuadernu, cuadernu a aneddos
ğŸ“ƒ	documentu, pÃ gina, pÃ gina pinnigada, pÃ¬nniga
ğŸ“œ	pabiru, paperi, pergamena, rÃ²tulu
ğŸ“„	documentu, pÃ gina
ğŸ“°	cuotidianu, diÃ riu, giornale, noas, novas
ğŸ—	alloturadu, cuotidianu, diÃ riu, giornale, giornale alloturadu, noas, novas
ğŸ“‘	etichetas, etichetas sinnalibru, marcadore, marcadores, sinnalibros, sinnalibru
ğŸ”–	marcadore, sinnalibru
ğŸ·ï¸	eticheta
ğŸ’°ï¸	dinare, dinari, dÃ²llaru, sacu, sacu de dinare, sacu de dinari
ğŸª™	ascusÃ²rgiu, dinare, dinari, metallu, moneda, oro, prata, siddadu
ğŸ’´	banconota, banconota in yen, dinare, dinari, moneda, yen
ğŸ’µ	banconota, banconota in dÃ²llaros, dinare, dinari, dÃ²llaros, dÃ²llaru, moneda
ğŸ’¶	banconota, banconota in Ã¨uros, dinare, dinari, moneda, Ã¨uro, Ã¨uros, Ã¨uru
ğŸ’·	banconota, banconota in isterlinas, dinare, dinari, isterlina, isterlinas, moneda
ğŸ’¸	banconota, dinare, dinare bolende, dinare chi bolat, dinare cun is alas, dinare cun sas alas, dinari, dinari bolende, dinari chi bolat, dinari cun is alas, dinari cun sas alas
ğŸ’³ï¸	carta, carta de crÃ¨ditu, crÃ¨ditu, dinare, dinari
ğŸ§¾	contabilidade, iscontrinu, retzida, retzida de pagamentu, retzida fiscale
ğŸ’¹	dinare, dinari, grÃ ficu, grÃ ficu artziende, grÃ ficu chi Ã rtziat, grÃ ficu chi Ã rtziat cun su sÃ¬mbulu de su yen, grÃ ficu in artziada, mercadu in artziada, mercadu in pesada, yen
âœ‰ï¸	busta, email, lÃ¬tera, lÃ¬tera eletrÃ²nica, posta, posta eletrÃ²nica
ğŸ“§	email, lÃ¬tera, lÃ¬tera eletrÃ²nica, posta, posta eletrÃ²nica
ğŸ“¨	email, lÃ¬tera, lÃ¬tera eletrÃ²nica, lÃ¬tera in intrada, messÃ giu in intrada, posta, posta eletrÃ²nica, posta in intrada
ğŸ“©	busta, busta cun fritza, email, fritza, lÃ¬tera, lÃ¬tera eletrÃ²nica, posta, posta eletrÃ²nica
ğŸ“¤ï¸	cartella, cartella de essida, email, lÃ¬tera, lÃ¬tera eletrÃ²nica, posta, posta eletrÃ²nica, posta imbiada, posta in essida
ğŸ“¥ï¸	cartella, cartella de intrada, email, lÃ¬tera, lÃ¬tera eletrÃ²nica, posta, posta eletrÃ²nica, posta in intrada, posta retzida
ğŸ“¦ï¸	iscÃ tula, pacu
ğŸ“«ï¸	banderedda, cassita postale, cassita postale serrada cun sa banderedda artziada, posta, serrada, tancada
ğŸ“ªï¸	banderedda, cassita postale, cassita postale serrada cun sa banderedda abbassada, posta, serrada, tancada
ğŸ“¬ï¸	banderedda, cassita postale, cassita postale aberta cun sa banderedda artziada, posta, serrada, tancada
ğŸ“­ï¸	aberta, banderedda, cassita postale, cassita postale aberta cun sa banderedda abbassada, posta
ğŸ“®	cassita de sas lÃ¬teras, imbiare posta, posta
ğŸ—³ï¸	eletziones, ischeda de votu, ischeda eletorale, urna eletorale cun ischeda, votu
âœï¸	lapis
âœ’ï¸	penninu, pinna, pinnina, pinninu, pinninu nieddu, temperedda, temperedda niedda
ğŸ–‹ï¸	penninu, pinna, pinna istilogrÃ fica, pinnina, pinninu, temperedda
ğŸ–Šï¸	pinna, pinna a isfera
ğŸ–Œï¸	pintare, pintura, pintzellu
ğŸ–ï¸	pastellu, pastellu a cera
ğŸ“	apuntos, apuntu, lÃ pis, nota, punta de billete
ğŸ’¼	documentos, ufÃ¬tziu, valigedda
ğŸ“	archÃ¬vios, cartella, cartella de archÃ¬vios, cartella de documentos, documentos
ğŸ“‚	archÃ¬vios, cartella, cartella aberta, cartella de archÃ¬vios aberta, cartella de documentos aberta, documentos
ğŸ—‚ï¸	documentos, ischedÃ riu, ordinare, partzidores, partzidores pro ischedÃ riu, Ã¬nditze
ğŸ“…	calendÃ riu, data
ğŸ“†	calendÃ riu, calendÃ riu de istratzare
ğŸ—’ï¸	apuntos, blocu pro apuntos a ispirale, blocu pro notas a ispirale, ispirale, nota, notas
ğŸ—“ï¸	calendÃ riu, calendÃ riu a ispirale, ispirale
ğŸ“‡	documentos, ischeda, ischedas, ischedÃ riu, ordinare, rolodex, Ã¬nditze
ğŸ“ˆ	artziada, balÃ ngiu, crÃ¨schida, grÃ ficu, grÃ ficu cara a susu, grÃ ficu in artziada, tendÃ¨ntzia
ğŸ“‰	achirrada, calada, grÃ ficu, grÃ ficu cara a giosso, grÃ ficu in achirrada, minimada, pÃ¨rdida, tendÃ¨ntzia
ğŸ“Š	barras, colunnas, grÃ ficu, grÃ ficu a barras, grÃ ficu a colunnas
ğŸ“‹ï¸	apuntos, portablocu, punta de billete
ğŸ“Œ	puntighedda, puntina, puntina de disinnu
ğŸ“	puntighedda, puntina, puntina de disinnu, puntina tunda
ğŸ“	brestiedda, fermÃ lliu, grafeta
ğŸ–‡ï¸	brestieddas, fermÃ llios, grafeta, grafetas, grafetas collegadas
ğŸ“	aina, geometria, medire, ria, riga, righighedda, traste, trastu
ğŸ“	aina, cartabonu, geometria, iscuadra, medire, traste, trastu
âœ‚ï¸	aina, ferros, fÃ²rfighes, fÃ²rtzighes, serritos, traste, trastu
ğŸ—ƒï¸	archiviare, archÃ¬viu, cuntenidore, documentos, ischedÃ riu, ischedÃ riu de mesa
ğŸ—„ï¸	archiviare, archÃ¬viu, armÃ riu, documentos, ischedÃ riu, ischedÃ riu de ufÃ¬tziu, mÃ²bile
ğŸ—‘ï¸	botu de sâ€™arga, botu de sâ€™Ã liga
ğŸ”’ï¸	luchete, luchete serradu, luchetu, morisca, moriscu, serradu, tancadu, tancadura
ğŸ”“ï¸	abertu, luchete, luchete abertu, luchetu, morisca, moriscu
ğŸ”	critografia, luchete cun pinna istilogrÃ fica, luchete cun pinninu, luchete serradu cun pinninu, luchete tancadu cun pinninu, luchetu, morisca, moriscu, penninu, pinninu, riservadera, serradu, tancadu, tzifradura
ğŸ”	crae, luchete, luchete serradu cun crae, luchetu, morisca, moriscu, seguru, serradu, serradu a crae, tancadu, tancadu a crae
ğŸ”‘	crae, crae de intrada, serrare, serrare a crae, tancare, tancare a crae
ğŸ—ï¸	crae, crae antiga, crae betza, serrare, serrare a crae, tancare, tancare a crae
ğŸ”¨	marteddu, traste, trastu
ğŸª“	buscajolu, buscarinu, istrale, segalinna, segantinu, segare linna, segura
â›ï¸	iscavare, miniera, piconare, picone, picu, pÃ stinu, traste, trastu
âš’ï¸	marteddu, marteddu e picu, picone, picu, traste, trastes, trastu
ğŸ› ï¸	crae inglesa, marteddu, marteddu e crae inglesa, traste, trastes, trastu
ğŸ—¡ï¸	arma, istile, istocu, leputzu, pugnale
âš”ï¸	arma, armas, irrugadas, ispadas, ispadas rugradas, rugradas
ğŸ”«	abba, arma, pistola, pistola a abba, traste, trastu
ğŸªƒ	austrÃ lia, boomerang, rebbÃ tida, rebÃ²tiu
ğŸ¹	arcu, arcu e fritza, artzeri, fritza, sagitÃ riu, zodÃ¬acu
ğŸ›¡ï¸	arma, iscudu
ğŸªš	aina, linna, mastru de linna, serra, serracu, traste, trastu
ğŸ”§	crae inglesa, traste, trastu
ğŸª›	catzavite, catziavite, traste, trastu
ğŸ”©	bullone, traste, trastu, vite, vite e bullone
âš™ï¸	cumponente, ingranÃ giu, mecanismu, roda dentada, traste, trastu
ğŸ—œï¸	fissare, istringone, istrÃ¬nghere, sergente, traste, trastu
âš–ï¸	balantza, bilÃ ntzia, giustÃ¬tzia, pesare, pratos de sa bilÃ ntzia, zodÃ¬acu
ğŸ¦¯	atzessibilidade, bÃ culu arbu, bÃ culu biancu, bÃ culu pro ipovedentes, bÃ culu pro tzegos, tzegos, tzegu
ğŸ”—	cadena, duos aneddos, ligÃ mene
â›“ï¸	cadena, cadenas
ğŸª	carabatu, crocu, cÃ ncaru, gantzu, grocu, rampinu, satzu, unchinu, Ã¹nchinu
ğŸ§°	ainas, cassita, cassita de is trastes, cassita de is trastos, cassita de sos trastes, cassita de sos trastos, mecÃ nicu, trastes, trastos
ğŸ§²	atratzione, calamita, magnete, magnetismu, magnÃ¨tica
ğŸªœ	aperrinzada, apiligada, artziare, brocu, iscala, iscalinu
âš—ï¸	aina, chÃ¬mica, lambicu, traste, trastu
ğŸ§ª	chÃ¬mica, chÃ¬micu, esperimentos, isciÃ¨ntzia, laboratÃ²riu, proveta, siÃ¨ntzia
ğŸ§«	batÃ¨rios, biÃ²logu, coltura, discu de Petri, laboratÃ²riu, piastra de Petri
ğŸ§¬	bida, biÃ²logu, cÃ²dighe genÃ¨ticu, dna, evolutzione, gene, genes, genÃ¨tica
ğŸ”¬	aina, isciÃ¨ntzia, microscÃ²piu, siÃ¨ntzia, traste, trastu
ğŸ”­	aina, isciÃ¨ntzia, siÃ¨ntzia, telescÃ²piu, traste, trastu
ğŸ“¡	antenna, antenna parabÃ²lica, antenna satellitare, parÃ bola, satÃ¨llite
ğŸ’‰	agu, dutora, dutore, inietzione, maladia, malÃ ida, malÃ idu, meighina, mÃ¨iga, mÃ¨igu, siringa
ğŸ©¸	donatzione de sÃ mbene, ferta, flussu de sa madre, gÃ¹tiu, gÃ¹tiu de sÃ mbene, meighina, menstru, ministru, regla, sÃ mbene, tribisu
ğŸ’Š	dutore, maladia, meighina, mÃ¨igu, pÃ¬llola
ğŸ©¹	achillo, carta de BrÃ¨scia, isparadrapa, liga, tafetanu, tzerotu, tzirone
ğŸ©¼	agiudu a sa mobilidade, bacheddu, bÃ culu, disabilidade, ferta, istampella, suportu, tesiddu
ğŸ©º	coro, dutora, dutore, isteteoscÃ²piu, meighina, mÃ¨iga, mÃ¨igu
ğŸ©»	dutora, dutore, ischÃ¨letru, meighina, mÃ¨iga, mÃ¨igu, ossos, radiografia, rajos x
ğŸšª	ghenna
ğŸ›—	artziadore, ascensore, atzessibilidade, monta-cÃ rrigos, piga e fala, pigaefala
ğŸª	ispricu, reflessu
ğŸªŸ	abertura, bastimentu, bentana, trasparente, ventana, vista, Ã era frisca
ğŸ›ï¸	albergu, dormire, letu, posada
ğŸ›‹ï¸	albergu, divanu, divanu cun lÃ mpada, lÃ mpada, otomana, otomana cun lÃ mpada, otomanu, otomanu cun lÃ mpada, posada
ğŸª‘	cadira, cadrea, sÃ¨tzida
ğŸš½	bassa, cÃ²modu, gabinete, latrina, privada, toeleta, tzesso, vasu
ğŸª 	aspiratzione, bagnu, idrÃ ulicu, iscÃ ricu, istupa-lavandinos, ventosa
ğŸš¿	abba, dÃ²tzia
ğŸ›	bagnera, bagnu
ğŸª¤	cassatopis, esca, latzu, ratera, ratonera, sorigÃ rgiu, trampa, trÃ pula
ğŸª’	lesorja de barba, lesorja de barbieri, rasoju, resorza, resorza de barba, resorza de barbieri
ğŸ§´	ampulla, ampullita de bÃ lsamu, ampullita de crema, bÃ lsamu, crema, flacone
ğŸ§·	aguzacrica, ispilla de bÃ lia, ispillabÃ lia, pannolone, punk rock
ğŸ§¹	coga, innetare, iscoba, iscobare, limpiare, majÃ rgia, mundare, sabunare
ğŸ§º	banastra, canestra, canistedda, canisteddu, canistru, cofinu, corbe, corbedda, corbulita, discu, discuedda, erone, isportinu, picheddu, pischedda, postura
ğŸ§»	carta igiÃ¨nica, carta suspidora, cartasciuga, pabilu, pabilu de cÃ²mudu, paperi, paperi de cÃ²mudu, paperi igiÃ¨nicu, rÃ²tulos de paperi, rÃ²tulu de paperi
ğŸª£	baddidone, cannada, carciga, cartzida, casiddu, coberina, cubedina, istagnale, istangiada, malinzone, malune, maningione, mannirone, puale, sÃ¨chia, umpriolu
ğŸ§¼	bagnu, ispuma, sabone, saboneta, sabunÃ²ngiu
ğŸ«§	abbajolas, abbajolos, bolloncas, bubbulicas, bullas, in suta de sâ€™abba, lÃ¬mpiu, netu, pabeddas, pibisias, rutu, sabone
ğŸª¥	bagnu, dentale, dentes, igiene, innetare, ispatzulinu, ispatzulinu de dentes, ispumadoreddu, limpiare, netu, sabunare
ğŸ§½	assorbimentu, ispugna, ispÃ²ngia, porosa, sabunare
ğŸ§¯	fogu, frammas, istudadore, istudare, mÃ²rrere
ğŸ›’	carreddu, carrellu de is cÃ²mporas, carrellu de sas cÃ²mporas, carrellu de sâ€™ispesa, carrutzu, cÃ²mporas
ğŸš¬	pipare, pipÃ²ngiu, sigareta, tzica
âš°ï¸	baule, cÃ scia, funerale, interru, morte
ğŸª¦	campusantu, losa, tumba, tzimitÃ²riu
âš±ï¸	chisina, funerale, morte, urna, urna funerÃ ria
ğŸ—¿	cara, fatze, istÃ tua, moai, moai de sâ€™Ã¬sula de Pasca, moyai, Ã¬sula de Pasca
ğŸª§	cartellu, corteu, manifestatzione, pichetu, protesta, signale, sinnale
ğŸªª	carta de identidade, credentziales, documentu de identidade, pantente, seguresa, tÃ¨ssera
ğŸ	bandera, bandera a iscacos, cursa, pÃ²diu
ğŸš©	bandera, bandera ruja, bandera triangulare, banderedda, banderedda ruja, banderedda ruja triangulare
ğŸŒ	Giapone, banderas, banderas de su Giapone, banderas de su Giapone irrugadas, banderas de su Giapone rugradas, banderas giaponesas, banderas giaponesas irrugadas, banderas giaponesas rugradas, banderas irrugadas, banderas rugradas, festa
ğŸ´	bandera a su bentu, bandera isbentulada, bandera niedda
ğŸ³ï¸	bandera a su bentu, bandera arba, bandera bianca, bandera isbentulada, resa
ğŸ³â€ğŸŒˆ	arcu de chelu, bandera de sâ€™arcu de chelu, chirchiola
ğŸ³â€âš§	bandera asulu, biancu e rosa, bandera de sos transgÃ¨neres, transgÃ¨nere, transgÃ¨neres
ğŸ´â€â˜ 	Jolly Roger, ascusÃ²rgiu, bandera de sos piratas, botinu, corsaros, corsaru, pirata, piratas, siddadu
Â¤	valuta disconnota
Ö	dram armenu
Ø‹	afgani afganu
à§³	taka bangladesu
à¸¿	baht tailandesu
áŸ›	riel cambogianu
â‚¡	colÃ³n costaricanu
â‚¦	naira nigeriana
â‚§	peseta ispagnola
â‚ª	siclu nou israelianu
â‚«	dong vietnamesu
â‚­	kip laotianu
â‚®	tugrik mÃ²ngolu
â‚²	guaranÃ­ paraguayanu
â‚´	hryvnia ucraina
â‚µ	cedi ganesu
â‚¸	tenge kazaku
â‚º	lira turca
â‚¼	manat azeru
â‚¾	lari georgianu
ğŸ»	colore de sa pedde, pedde crara, pedde de colore craru, tonalidade
ğŸ¼	colore de sa pedde, pedde bastante crara, pedde crara bastante, pedde de colore bastante craru, tonalidade
ğŸ½	colore de sa pedde, pedde de colore mesanu, pedde de colore mÃ¨diu, pedde in colore de olia, tonalidade
ğŸ¾	colore de sa pedde, pedde bastante iscura, pedde iscura bastante, tonalidade
ğŸ¿	colore de sa pedde, pedde de colore iscuru, pedde iscura, tonalidade
